M,M,M,M,M,M,M,M,M,M
M,C,C,C,C,C,C,R,C,M
M,C_b,C,M,R,R,C,C,C,M
M,C,C,C,M,C,C,R,C,M
M,M,C,C,C,C,C,C,C,M
M,C,C,R,M,C_g,M,C,C,M
M,C,C,C,C,C,M,C,C,M
M,C,C,M,R,C,M,R_s,C,M
M,R,C,C,C,C,C,C,C,M
M,M,M,M,M,M,M,M,M,M